-1 -1 -1 -1 -1 -1 -1 -1 -1 -1 -1 -1 -1 -1 -1 -1 -1 -1 -1 -1 -1 -1 -1 -1 -1 -1 -1 -1 -1 -1 -1 -1 -1 -1 -1 -1 -1 -1
-1 -1 -1 -1 -1 -1 -1 -1 -1 -1 0 2 2 1 1 2 1 2 1 2 1 2 1 2 1 2 1 2 2 3 -1 -1 -1 -1 -1 -1 -1 -1
-1 -1 -1 -1 -1 -1 -1 -1 -1 -1 0 2 2 1 1 2 1 2 1 2 1 2 1 2 1 2 1 2 2 3 -1 -1 -1 -1 -1 -1 -1 -1
-1 -1 -1 -1 -1 -1 -1 -1 -1 -1 0 2 2 1 1 2 1 2 1 2 1 2 1 2 1 2 1 2 2 3 -1 -1 -1 -1 -1 -1 -1 -1
-1 -1 -1 -1 -1 -1 -1 -1 -1 -1 4 5 5 6 6 6 5 6 5 6 6 6 6 5 5 6 5 6 5 6 -1 -1 -1 -1 -1 -1 -1 -1
-1 -1 -1 -1 -1 -1 -1 -1 -1 -1 4 5 5 6 6 6 5 5 6 5 6 6 5 5 6 6 5 6 5 6 -1 -1 -1 -1 -1 -1 -1 -1
-1 -1 -1 -1 -1 -1 -1 -1 -1 -1 4 5 5 6 6 5 5 5 6 5 6 5 5 5 6 6 5 6 6 5 -1 -1 -1 -1 -1 -1 -1 -1
-1 -1 -1 -1 -1 -1 -1 -1 -1 -1 4 5 5 6 6 5 6 5 6 5 6 5 5 5 5 6 5 6 6 5 -1 -1 -1 -1 -1 -1 -1 -1
-1 -1 -1 -1 -1 -1 -1 -1 -1 -1 4 5 5 6 5 6 6 5 6 5 6 5 5 5 5 6 5 6 6 5 -1 -1 -1 -1 -1 -1 -1 -1
-1 -1 -1 -1 -1 -1 -1 -1 -1 -1 4 5 5 6 5 5 6 5 6 5 5 5 5 5 5 6 5 6 6 5 -1 -1 -1 -1 -1 -1 -1 -1
-1 -1 -1 -1 -1 -1 -1 -1 -1 -1 4 5 5 6 5 5 6 5 6 5 5 5 5 5 6 5 5 6 6 5 -1 -1 -1 -1 -1 -1 -1 -1
-1 -1 -1 -1 -1 -1 -1 -1 -1 -1 4 5 5 6 6 5 6 5 6 6 5 5 5 5 6 5 5 6 6 5 -1 -1 -1 -1 -1 -1 -1 -1
-1 -1 -1 -1 -1 -1 -1 -1 -1 -1 4 5 5 6 6 5 6 5 5 6 5 6 5 6 5 6 5 6 6 6 -1 -1 -1 -1 -1 -1 -1 -1
-1 -1 -1 -1 -1 -1 -1 -1 -1 -1 4 5 5 6 6 5 6 5 5 6 5 6 5 6 5 6 5 6 5 6 -1 -1 -1 -1 -1 -1 -1 -1
-1 -1 -1 -1 -1 -1 -1 -1 -1 -1 4 5 5 6 6 5 6 5 5 6 5 6 5 6 5 6 5 5 6 6 -1 -1 -1 -1 -1 -1 -1 -1
-1 -1 -1 -1 -1 -1 -1 -1 -1 -1 4 5 5 6 6 5 6 5 5 5 5 6 5 6 5 6 5 5 6 6 -1 -1 -1 -1 -1 -1 -1 -1
-1 -1 -1 -1 -1 -1 -1 -1 -1 -1 4 5 5 6 6 5 6 5 5 5 5 5 5 5 5 6 5 5 6 6 -1 -1 -1 -1 -1 -1 -1 -1
-1 -1 -1 -1 -1 -1 -1 -1 -1 -1 4 5 5 6 5 5 6 5 5 5 5 5 6 5 5 6 5 5 5 6 -1 -1 -1 -1 -1 -1 -1 -1
-1 -1 -1 -1 -1 -1 -1 -1 -1 -1 4 5 5 6 5 5 6 5 5 5 5 5 6 5 5 6 5 5 5 6 -1 -1 -1 -1 -1 -1 -1 -1
-1 -1 -1 -1 -1 -1 -1 -1 -1 -1 4 5 5 6 5 5 6 5 5 6 5 5 6 5 5 6 5 5 5 6 -1 -1 -1 -1 -1 -1 -1 -1
-1 -1 -1 -1 -1 -1 -1 -1 -1 -1 4 5 5 6 5 5 5 5 5 6 5 5 6 5 5 5 5 5 5 6 -1 -1 -1 -1 -1 -1 -1 -1
-1 -1 -1 -1 -1 -1 -1 -1 -1 -1 4 5 5 6 5 6 5 5 5 5 5 5 6 5 5 5 6 5 5 6 -1 -1 -1 -1 -1 -1 -1 -1
-1 -1 -1 -1 -1 -1 -1 -1 -1 -1 4 5 5 6 5 6 5 5 5 5 5 6 6 5 5 5 6 5 5 6 -1 -1 -1 -1 -1 -1 -1 -1
-1 -1 -1 -1 -1 -1 -1 -1 -1 -1 4 5 5 6 5 6 5 5 5 5 5 6 6 5 5 5 6 5 5 6 -1 -1 -1 -1 -1 -1 -1 -1
-1 -1 -1 -1 -1 -1 -1 -1 -1 -1 4 5 5 6 6 5 6 6 6 6 6 6 6 6 6 6 6 5 5 6 -1 -1 -1 -1 -1 -1 -1 -1
-1 -1 -1 -1 -1 -1 -1 -1 -1 -1 -1 -1 -1 -1 -1 -1 -1 -1 -1 -1 -1 -1 -1 -1 -1 -1 -1 -1 -1 -1 -1 -1 -1 -1 -1 -1 -1 -1