#tileset
assets/tileset.png
12 12
tile0: empty
tile1: empty
tile2: full
tile3: empty
tile4: empty
tile5: empty
tile6: empty
tile7: empty
tile8: empty
tile9: full
tile10: empty
tile11: empty
tile12: empty
tile0: empty
tile1: empty
tile2: full
tile3: empty
tile4: empty
tile5: empty
tile6: empty
tile7: empty
tile8: empty
tile9: full
tile10: empty
tile11: empty
tile12: empty
tile0: empty
tile1: empty
tile2: full
tile3: empty
tile4: empty
tile5: empty
tile6: empty
tile7: empty
tile8: empty
tile9: full
tile10: empty
tile11: empty
tile12: empty
tile0: empty
tile1: empty
tile2: full
tile3: empty
tile4: empty
tile5: empty
tile6: empty
tile7: empty
tile8: empty
tile9: full
tile10: empty
tile11: empty
tile12: empty
tile0: empty
tile1: empty
tile2: full
tile3: empty
tile4: empty
tile5: empty
tile6: empty
tile7: empty
tile8: empty
tile9: full
tile10: empty
tile11: empty
tile12: empty
tile0: empty
tile1: empty
tile2: full
tile3: empty
tile4: empty
tile5: empty
tile6: empty
tile7: empty
tile8: empty
tile9: full
tile10: empty
tile11: empty
tile12: empty
tile0: empty
tile1: empty
tile2: full
tile3: empty
tile4: empty
tile5: empty
tile6: empty
tile7: empty
tile8: empty
tile9: full
tile10: empty
tile11: empty
tile12: empty
tile0: empty
tile1: empty
tile2: full
tile3: empty
tile4: empty
tile5: empty
tile6: empty
tile7: empty
tile8: empty
tile9: full
tile10: empty
tile11: empty
tile12: empty
tile0: empty
tile1: empty
tile2: full
tile3: empty
tile4: empty
tile5: empty
tile6: empty
tile7: empty
tile8: empty
tile9: full
tile10: empty
tile11: empty
tile12: empty
tile0: empty
tile1: empty
tile2: full
tile3: empty
tile4: empty
tile5: empty
tile6: empty
tile7: empty
tile8: empty
tile9: full
tile10: empty
tile11: empty
tile12: empty
tile0: empty
tile1: empty
tile2: full
tile3: empty
tile4: empty
tile5: empty
tile6: empty
tile7: empty
tile8: empty
tile9: full
tile10: empty
tile11: empty
tile12: empty
tile0: empty
tile1: empty
tile2: full
tile3: empty
tile4: empty
tile5: empty
tile6: empty
tile7: empty
tile8: empty
tile9: full
tile10: empty
tile11: empty
tile12: empty
#level
38 26
0 12 13 13 13 13 13 14 0 0 0 0 0 0 0 0 0 0 0 24 25 0 0 0 0 0 0 0 0 0 106 107 2 2 2 9 2 127
0 15 31 32 33 34 35 15 0 0 0 0 0 0 0 0 0 0 0 36 37 0 0 0 18 19 20 0 0 0 106 107 2 93 94 94 94 94
0 15 43 44 45 46 47 15 0 0 0 0 0 0 0 0 0 0 0 0 0 0 0 0 75 1 49 0 0 0 106 107 2 105 64 65 65 66
0 15 55 56 57 58 59 15 0 0 0 0 18 19 20 0 0 0 0 0 0 0 0 0 63 29 30 0 0 0 106 107 2 105 76 77 77 78
0 15 67 68 69 70 71 15 0 0 0 0 75 1 49 0 0 0 0 0 0 0 0 0 0 41 42 0 0 0 106 107 9 105 88 89 89 90
0 15 79 80 81 82 83 15 0 0 0 0 63 29 30 0 0 0 0 0 0 0 0 0 0 0 0 0 0 0 106 107 2 105 100 101 101 102
0 15 0 0 0 0 0 15 0 0 0 0 0 41 42 0 0 0 0 0 0 0 0 0 0 0 0 0 0 0 106 107 2 105 112 113 113 114
0 16 13 13 0 13 13 17 0 0 0 0 0 0 0 0 0 0 0 0 18 19 20 0 0 0 0 0 0 0 106 107 2 105 124 125 125 126
0 0 0 0 0 0 0 0 0 0 0 0 0 0 0 0 0 0 0 0 75 1 49 0 0 0 0 0 0 0 106 107 2 105 136 91 92 138
0 0 0 0 0 0 0 0 0 0 0 0 0 0 0 0 0 0 0 0 63 29 30 0 0 0 0 0 0 0 106 107 2 105 133 103 104 135
0 23 23 23 23 23 0 0 23 23 23 23 23 23 48 0 0 0 0 0 0 41 42 0 0 0 0 0 106 134 118 119 2 117 87 4 4 142
0 118 118 118 118 118 118 118 118 118 118 118 118 118 137 0 0 0 0 0 0 0 0 0 0 0 0 0 0 107 9 2 2 2 99 4 4 143
107 2 115 116 2 9 2 2 2 2 115 116 2 2 105 0 3 22 22 22 3 0 0 0 0 0 0 0 106 107 2 115 116 2 99 4 4 143
107 2 127 128 2 2 2 2 2 2 127 128 2 2 105 0 21 26 27 28 10 0 0 18 19 20 0 0 0 107 2 127 128 9 99 4 4 143
107 2 2 2 2 2 115 116 2 2 9 9 2 2 105 0 21 38 39 40 10 0 0 75 1 49 0 0 0 107 2 2 2 2 99 4 4 143
107 2 2 9 2 2 127 128 2 2 2 2 2 2 105 0 21 50 51 52 10 0 0 63 29 30 0 0 0 139 94 94 94 94 111 4 4 131
139 94 94 94 94 94 94 94 94 94 94 94 94 94 140 0 3 11 11 11 3 0 0 0 41 42 0 0 0 0 0 0 0 0 129 4 4 130
3 3 3 3 3 3 3 3 3 3 3 3 3 3 3 3 3 3 3 3 3 3 3 3 3 3 3 3 3 3 3 3 3 3 6 7 7 8
60 61 61 61 61 61 61 61 61 61 61 61 61 62 5 4 4 4 4 4 4 4 5 60 61 61 61 61 61 61 61 61 61 61 61 61 61 62
72 73 73 73 73 73 73 73 73 73 73 73 73 74 5 4 4 4 4 4 4 4 5 72 73 73 73 73 73 73 73 73 73 73 73 73 73 74
84 85 85 85 85 85 85 85 85 85 85 85 85 86 5 4 4 4 4 4 4 4 5 84 85 85 85 85 85 85 85 85 85 85 85 85 85 86
96 97 97 97 97 97 97 97 97 97 97 97 97 98 5 4 4 4 4 4 4 4 5 96 97 97 97 97 97 97 97 97 97 97 97 97 97 98
108 109 109 109 109 109 109 109 109 109 109 109 109 110 5 4 4 4 4 4 4 4 5 108 109 109 109 109 109 109 109 109 109 109 109 109 109 110
120 121 122 123 120 121 122 123 120 122 120 121 122 123 5 4 4 4 4 4 4 4 5 120 121 122 123 120 121 122 123 120 121 122 120 121 122 123
132 132 132 132 132 132 132 132 132 132 132 132 132 132 5 4 4 4 4 4 4 4 5 132 132 132 132 132 132 132 132 132 132 132 132 132 132 132
4 4 4 4 4 4 4 4 4 4 4 4 4 4 4 4 4 4 4 4 4 4 4 4 4 4 4 4 4 4 4 4 4 4 4 4 4 4
#fin