-1 -1 -1 -1 -1 -1 -1 -1 -1 -1 -1 -1 -1 -1 -1 -1 -1 -1 -1 -1 -1 -1 -1 -1 -1 -1 -1 -1 -1 -1 -1 -1 -1 -1 -1 -1 -1 -1
-1 -1 -1 -1 -1 -1 -1 -1 -1 -1 -1 -1 -1 -1 128 129 129 129 129 130 -1 -1 -1 -1 -1 -1 -1 -1 -1 -1 -1 -1 -1 -1 -1 -1 -1 -1
-1 -1 -1 -1 -1 -1 -1 -1 -1 -1 -1 -1 -1 -1 167 -1 -1 -1 -1 146 -1 -1 -1 -1 -1 -1 -1 -1 -1 -1 -1 -1 -1 -1 -1 -1 -1 -1
-1 -1 -1 -1 -1 -1 -1 -1 -1 -1 -1 -1 128 129 183 -1 -1 -1 -1 146 129 129 129 129 129 129 129 130 -1 -1 -1 -1 -1 -1 -1 -1 -1 -1
-1 -1 -1 -1 -1 -1 -1 -1 -1 -1 -1 -1 144 -1 -1 -1 -1 -1 -1 146 -1 -1 -1 -1 -1 -1 -1 146 -1 -1 -1 -1 -1 -1 -1 -1 -1 -1
-1 -1 -1 -1 -1 -1 -1 -1 128 129 129 129 160 218 219 133 142 143 213 162 -1 -1 -1 -1 -1 -1 -1 146 -1 -1 -1 -1 -1 -1 -1 -1 -1 -1
-1 -1 -1 -1 -1 -1 -1 -1 151 -1 -1 -1 176 234 235 149 158 159 229 178 -1 -1 -1 -1 -1 -1 -1 146 -1 -1 -1 -1 -1 -1 -1 -1 -1 -1
-1 -1 -1 -1 -1 -1 -1 -1 151 -1 -1 -1 -1 -1 -1 -1 174 175 -1 194 -1 -1 -1 -1 -1 -1 -1 146 -1 -1 -1 -1 128 129 129 129 130 -1
-1 -1 -1 -1 128 129 129 129 129 130 -1 -1 -1 -1 -1 -1 -1 -1 -1 -1 -1 -1 -1 -1 -1 -1 -1 146 -1 -1 -1 -1 144 -1 -1 -1 179 130
-1 -1 128 129 144 -1 -1 -1 -1 146 -1 -1 -1 -1 -1 -1 -1 -1 -1 -1 131 132 161 161 161 161 161 162 -1 -1 -1 -1 144 -1 -1 -1 -1 146
-1 -1 144 -1 144 -1 -1 -1 -1 146 -1 -1 -1 -1 -1 -1 -1 -1 -1 -1 147 148 177 177 177 177 177 178 -1 -1 -1 -1 167 -1 -1 -1 -1 146
-1 -1 144 -1 160 213 161 218 219 162 -1 -1 -1 -1 -1 -1 -1 -1 -1 -1 147 -1 -1 -1 -1 -1 -1 -1 -1 -1 -1 128 183 -1 -1 -1 -1 146
-1 -1 144 -1 176 229 177 234 235 178 -1 -1 -1 -1 -1 -1 -1 -1 -1 -1 147 -1 -1 -1 -1 -1 -1 -1 -1 -1 -1 144 -1 -1 -1 -1 -1 146
-1 -1 144 -1 -1 -1 -1 -1 -1 -1 -1 -1 -1 -1 -1 -1 -1 -1 -1 -1 163 -1 -1 -1 -1 -1 -1 -1 -1 -1 -1 144 -1 -1 -1 -1 -1 146
-1 -1 144 -1 -1 -1 -1 -1 -1 -1 -1 -1 -1 -1 -1 -1 -1 -1 -1 -1 179 129 129 129 129 129 129 129 129 129 129 144 -1 -1 -1 -1 -1 146
-1 -1 144 -1 -1 -1 -1 -1 -1 -1 -1 -1 -1 -1 -1 -1 -1 -1 -1 -1 -1 -1 -1 -1 -1 -1 -1 -1 -1 -1 -1 160 211 206 207 213 161 162
-1 -1 144 -1 -1 -1 -1 -1 -1 -1 -1 -1 -1 -1 -1 -1 -1 -1 -1 -1 -1 -1 -1 -1 -1 -1 -1 -1 -1 -1 -1 176 227 222 223 229 177 178
-1 -1 144 -1 -1 -1 -1 -1 -1 -1 -1 -1 -1 -1 -1 -1 -1 -1 -1 -1 128 129 129 129 129 130 -1 -1 -1 -1 -1 -1 -1 238 239 -1 146 -1
-1 -1 144 -1 -1 -1 -1 -1 -1 -1 -1 -1 -1 -1 -1 -1 -1 -1 -1 -1 144 -1 -1 -1 -1 146 -1 -1 -1 -1 -1 -1 -1 -1 -1 -1 146 -1
-1 -1 160 161 133 133 133 133 134 135 -1 -1 -1 -1 -1 -1 -1 -1 -1 -1 144 -1 -1 -1 -1 146 -1 -1 -1 -1 -1 -1 -1 -1 -1 -1 146 -1
-1 -1 176 177 149 149 149 149 150 151 -1 -1 -1 -1 -1 -1 -1 -1 -1 -1 160 213 161 218 219 162 -1 -1 -1 -1 -1 -1 -1 -1 -1 -1 146 -1
-1 -1 -1 -1 -1 -1 -1 -1 -1 144 -1 -1 -1 521 -1 -1 -1 -1 -1 -1 176 229 177 234 235 178 -1 -1 -1 -1 -1 -1 -1 -1 -1 -1 146 -1
-1 -1 -1 -1 -1 -1 -1 -1 -1 144 -1 -1 -1 -1 -1 -1 -1 -1 -1 -1 -1 -1 -1 -1 -1 -1 -1 131 161 161 161 161 161 161 161 161 162 -1
-1 -1 -1 -1 -1 -1 -1 -1 -1 144 -1 -1 -1 553 -1 -1 -1 -1 -1 -1 -1 -1 -1 -1 -1 -1 -1 147 177 177 177 177 177 177 177 177 178 -1
-1 -1 -1 -1 -1 -1 -1 -1 -1 160 161 161 161 161 161 161 161 161 161 161 161 161 161 161 161 161 161 162 -1 -1 -1 -1 -1 -1 -1 -1 -1 -1
-1 -1 -1 -1 -1 -1 -1 -1 -1 176 177 177 177 177 177 177 177 177 177 177 177 177 177 177 177 177 177 178 -1 -1 -1 -1 -1 -1 -1 -1 -1 -1