0 0 0 0 0 0 0 0 0 0 0 0 0 0 0 0 0 0 0 0 0 0 0 0 0 0 0 0 0 0 0 0 0 0 0 0 0 0
0 0 0 0 0 0 0 0 0 0 288 289 289 289 289 290 0 288 289 289 289 289 290 0 0 0 0 0 0 0 0 0 0 0 0 0 22 0
0 0 0 0 0 0 0 0 0 0 306 -1 -1 -1 -1 308 0 306 -1 -1 -1 -1 308 0 0 22 0 0 0 0 0 0 0 0 0 0 0 0
0 0 0 0 0 0 0 0 0 0 306 -1 -1 -1 -1 308 0 306 -1 -1 -1 -1 308 0 0 0 0 0 0 0 0 0 0 0 0 0 0 0
0 0 0 0 0 0 0 0 0 0 324 364 8 9 325 326 0 324 325 8 9 364 326 0 23 0 0 0 0 0 0 0 0 0 0 0 0 0
22 0 0 0 0 0 0 0 0 0 342 382 26 27 343 344 0 342 343 26 27 382 344 20 20 20 20 0 0 59 0 0 0 0 0 0 0 0
20 20 20 20 18 18 18 18 0 0 18 18 44 45 20 20 0 20 20 44 45 20 20 20 23 20 20 0 0 0 0 0 0 0 0 0 0 0
20 20 20 20 18 18 24 18 42 18 18 18 112 115 20 20 42 24 20 112 115 20 20 20 41 20 23 24 0 0 0 0 0 0 0 0 0 0
20 20 20 20 18 18 18 18 18 23 18 23 113 114 20 41 20 20 42 113 114 42 20 20 20 20 0 0 0 0 0 0 0 0 0 0 0 0
20 20 20 20 42 18 42 23 18 18 18 18 113 113 20 20 42 20 20 113 113 20 20 42 20 41 20 20 20 20 20 20 20 20 20 20 20 20
20 20 20 20 18 18 18 18 18 42 18 18 115 112 20 20 20 20 41 115 112 20 20 20 20 20 20 20 20 20 20 20 20 20 20 20 20 20
20 20 20 20 72 127 108 127 72 109 72 109 109 72 108 108 127 108 72 108 72 109 72 72 127 109 108 108 20 20 20 20 20 20 20 20 20 20
20 20 20 20 18 18 18 18 24 18 18 18 18 18 18 18 18 18 18 18 18 18 18 18 18 20 18 18 18 18 18 18 18 18 20 20 20 20
20 20 20 18 18 18 18 18 18 18 18 18 18 18 18 18 18 18 18 18 40 18 18 18 18 18 18 18 18 22 18 18 18 18 20 20 20 20
20 20 20 18 18 18 18 18 24 18 18 18 24 18 18 18 18 18 18 18 18 18 19 40 19 19 18 22 18 18 18 90 109 73 20 20 20 20
20 20 20 18 18 18 18 18 18 18 40 18 18 18 18 18 18 23 6 18 18 18 19 19 19 19 19 18 18 18 18 108 73 91 20 20 20 20
20 20 20 18 18 18 18 18 23 18 18 18 18 18 18 18 18 18 18 18 18 18 19 19 19 19 18 18 18 18 18 109 90 108 20 20 20 20
20 20 20 18 18 18 18 18 40 18 18 18 18 40 23 18 18 18 18 18 18 40 19 19 40 19 40 19 19 19 19 91 109 90 20 20 20 20
20 20 20 20 18 18 18 18 18 18 18 40 18 18 18 18 18 18 18 18 18 19 19 19 19 19 19 19 19 19 19 73 109 108 20 20 20 20
20 20 20 20 20 20 20 20 20 20 20 20 18 18 18 18 6 18 18 18 18 18 18 18 18 18 18 18 18 18 18 90 108 73 20 20 20 20
20 20 0 0 0 0 0 0 20 20 20 20 40 18 18 18 18 18 18 18 6 18 18 18 18 18 18 18 18 18 18 108 90 109 20 20 20 20
0 0 0 0 0 0 0 0 0 0 0 0 0 0 0 0 0 0 0 0 0 0 0 0 0 0 0 0 0 0 0 0 0 0 0 0 0 0
0 0 0 0 0 0 0 0 0 0 0 0 0 0 0 0 0 0 0 0 0 0 0 0 0 0 0 0 0 0 0 0 0 0 0 0 0 0
0 0 0 0 0 0 0 0 0 0 0 0 0 0 0 0 0 0 0 0 0 0 0 0 0 0 0 0 0 0 0 0 0 0 0 0 0 0
0 0 0 0 0 0 0 0 0 0 0 0 0 0 0 0 0 0 0 0 0 0 0 0 0 0 0 0 0 0 0 0 0 0 0 0 0 0
0 0 0 0 0 0 0 0 0 0 0 0 0 0 0 0 0 0 0 0 0 0 0 0 0 0 0 0 0 0 0 0 0 0 0 0 0 0
