-1 -1 -1 -1 -1 -1 -1 -1 -1 -1 -1 -1 -1 -1 -1 -1 -1 -1 368 369 -1 -1 -1 -1 -1 -1 -1 -1 -1 -1 -1 -1 -1 -1 -1 -1 -1 -1
-1 -1 -1 -1 -1 -1 -1 -1 -1 -1 -1 -1 -1 -1 339 -1 -1 -1 384 385 -1 -1 -1 -1 379 380 381 -1 -1 -1 -1 -1 -1 -1 -1 -1 -1 -1
-1 -1 -1 -1 -1 -1 -1 240 241 242 243 244 -1 -1 -1 -1 -1 -1 -1 -1 -1 -1 374 375 376 396 397 -1 -1 -1 -1 -1 -1 -1 -1 -1 -1 -1
-1 -1 -1 -1 -1 -1 -1 256 257 258 259 260 434 435 -1 -1 -1 -1 -1 -1 581 -1 390 391 392 412 413 -1 -1 -1 -1 -1 -1 -1 -1 -1 -1 -1
-1 -1 -1 -1 -1 -1 -1 272 273 274 275 276 450 451 -1 -1 -1 -1 -1 337 -1 -1 -1 -1 484 485 -1 -1 -1 -1 -1 -1 -1 -1 -1 -1 -1 -1
-1 -1 -1 -1 -1 -1 -1 288 289 290 291 292 -1 -1 -1 -1 -1 -1 -1 -1 -1 -1 -1 -1 500 501 516 517 -1 -1 -1 -1 -1 -1 -1 -1 -1 -1
-1 -1 -1 -1 -1 -1 -1 304 305 306 307 308 -1 -1 -1 -1 -1 -1 -1 -1 -1 -1 -1 454 455 -1 532 533 -1 -1 -1 -1 -1 368 369 -1 -1 -1
-1 -1 -1 -1 -1 400 401 -1 434 435 -1 -1 578 -1 -1 -1 -1 -1 -1 -1 -1 -1 -1 470 471 406 407 408 -1 -1 -1 -1 581 384 385 -1 377 378
-1 -1 -1 466 -1 416 417 -1 450 451 -1 -1 -1 -1 -1 -1 -1 -1 -1 -1 -1 -1 -1 486 487 422 423 424 -1 -1 -1 -1 -1 -1 -1 -1 393 579
-1 -1 -1 482 -1 -1 -1 -1 -1 -1 -1 -1 -1 -1 -1 -1 -1 -1 -1 -1 -1 -1 -1 -1 -1 213 -1 -1 -1 -1 -1 -1 -1 -1 -1 -1 -1 -1
-1 -1 -1 -1 -1 -1 -1 -1 -1 -1 -1 452 453 -1 -1 -1 -1 -1 -1 -1 -1 -1 -1 -1 -1 229 -1 -1 -1 -1 -1 -1 -1 -1 -1 -1 -1 -1
-1 -1 -1 -1 -1 -1 -1 -1 -1 -1 -1 468 469 -1 -1 -1 -1 -1 -1 404 405 -1 250 -1 -1 -1 -1 -1 -1 -1 -1 -1 -1 -1 337 -1 -1 -1
-1 -1 -1 -1 -1 -1 -1 -1 -1 -1 -1 -1 -1 -1 -1 -1 -1 -1 -1 420 421 265 266 267 -1 -1 -1 -1 -1 -1 -1 425 426 -1 -1 -1 571 572
-1 -1 -1 -1 -1 -1 581 -1 -1 480 -1 -1 -1 -1 -1 -1 -1 -1 -1 436 437 281 282 283 -1 456 457 -1 522 523 -1 441 442 -1 -1 -1 587 588
-1 -1 -1 -1 -1 -1 -1 -1 -1 -1 -1 -1 -1 -1 -1 -1 -1 -1 -1 -1 -1 297 298 299 -1 472 473 -1 538 539 -1 -1 -1 -1 -1 -1 -1 339
-1 -1 -1 -1 -1 -1 -1 -1 -1 -1 -1 474 475 -1 -1 -1 -1 -1 -1 -1 -1 313 314 315 -1 -1 -1 -1 554 555 -1 -1 -1 -1 -1 -1 -1 -1
-1 -1 -1 -1 -1 -1 -1 -1 -1 -1 -1 490 491 -1 493 494 -1 -1 -1 -1 -1 -1 -1 -1 -1 -1 -1 -1 -1 -1 -1 -1 -1 -1 -1 -1 -1 -1
-1 -1 498 -1 -1 -1 -1 -1 -1 -1 -1 506 507 -1 509 510 -1 -1 -1 -1 -1 -1 337 -1 -1 -1 -1 -1 -1 -1 -1 -1 -1 -1 -1 -1 579 -1
-1 -1 514 -1 -1 -1 -1 -1 -1 -1 -1 -1 -1 -1 -1 -1 -1 -1 -1 -1 -1 -1 -1 -1 -1 -1 -1 -1 -1 -1 -1 -1 -1 -1 -1 -1 -1 -1
-1 -1 -1 -1 -1 213 -1 -1 -1 425 426 -1 -1 -1 -1 -1 -1 -1 -1 -1 -1 -1 -1 -1 339 -1 -1 -1 -1 -1 -1 -1 -1 -1 -1 -1 -1 -1
-1 -1 -1 -1 -1 229 -1 -1 -1 441 442 -1 -1 -1 -1 -1 -1 -1 -1 -1 -1 -1 -1 -1 -1 -1 -1 -1 -1 -1 -1 -1 -1 -1 -1 -1 -1 -1
-1 -1 -1 -1 -1 -1 -1 -1 -1 -1 518 519 520 521 -1 -1 -1 -1 -1 -1 370 371 -1 -1 -1 -1 -1 -1 -1 -1 -1 -1 -1 -1 -1 -1 -1 -1
-1 -1 -1 -1 -1 -1 -1 -1 -1 -1 534 535 536 537 -1 -1 -1 -1 -1 -1 386 387 581 -1 -1 -1 -1 -1 -1 -1 -1 -1 213 -1 -1 -1 -1 -1
-1 -1 -1 -1 -1 -1 -1 -1 -1 -1 550 551 552 553 -1 -1 -1 -1 -1 -1 -1 -1 -1 -1 -1 -1 -1 -1 -1 -1 -1 -1 229 -1 -1 -1 -1 -1
-1 -1 -1 -1 -1 -1 -1 -1 -1 -1 -1 -1 -1 -1 -1 -1 -1 -1 -1 -1 -1 213 -1 -1 -1 -1 -1 -1 -1 -1 -1 -1 -1 -1 -1 -1 -1 -1
-1 -1 -1 -1 -1 -1 -1 -1 -1 -1 -1 -1 -1 -1 -1 -1 -1 -1 -1 -1 -1 229 -1 -1 -1 -1 -1 -1 -1 -1 -1 -1 -1 -1 -1 -1 -1 -1