-1 -1 -1 -1 -1 -1 -1 -1 -1 -1 -1 -1 -1 46 47 -1 -1 -1 -1 -1 -1 10 11 -1 -1 -1 -1 -1 -1 -1 117 118 119 120 -1 -1 -1 -1
-1 -1 -1 -1 -1 -1 -1 -1 -1 -1 -1 -1 -1 64 65 -1 -1 -1 -1 -1 -1 28 29 -1 -1 -1 -1 -1 -1 -1 135 136 137 138 -1 -1 -1 -1
-1 -1 -1 -1 -1 -1 -1 -1 -1 -1 -1 -1 -1 -1 -1 -1 -1 -1 -1 -1 -1 -1 -1 -1 -1 -1 -1 -1 -1 -1 153 154 155 156 -1 -1 -1 -1
-1 -1 -1 -1 -1 -1 -1 -1 -1 -1 -1 -1 -1 -1 -1 -1 -1 -1 -1 -1 -1 -1 -1 -1 -1 -1 -1 -1 -1 -1 171 172 173 174 -1 -1 -1 -1
-1 -1 -1 -1 -1 -1 -1 -1 -1 -1 -1 -1 -1 -1 -1 -1 -1 -1 -1 -1 -1 -1 -1 -1 -1 -1 -1 -1 -1 -1 189 190 191 192 -1 -1 -1 -1
-1 -1 -1 -1 -1 -1 -1 -1 -1 -1 -1 -1 -1 -1 -1 -1 -1 -1 -1 -1 -1 -1 -1 -1 -1 -1 50 51 52 -1 -1 -1 -1 -1 -1 -1 -1 -1
-1 -1 -1 -1 -1 -1 -1 -1 -1 -1 -1 -1 -1 -1 -1 -1 -1 -1 -1 -1 -1 -1 -1 -1 -1 67 68 69 70 -1 -1 -1 -1 -1 -1 -1 -1 -1
-1 -1 -1 -1 -1 -1 -1 -1 -1 -1 -1 -1 -1 -1 -1 -1 -1 -1 -1 -1 -1 -1 -1 -1 -1 85 86 87 -1 -1 -1 -1 338 339 -1 -1 -1 -1
-1 -1 -1 -1 -1 -1 -1 -1 -1 -1 -1 -1 -1 -1 -1 -1 -1 -1 -1 -1 -1 -1 -1 -1 -1 103 104 105 -1 -1 -1 -1 356 357 -1 -1 -1 -1
-1 -1 -1 -1 424 425 426 -1 -1 -1 -1 -1 -1 -1 -1 -1 424 425 426 -1 -1 -1 -1 -1 -1 121 122 123 -1 -1 -1 -1 -1 -1 -1 446 447 -1
-1 -1 -1 -1 442 443 444 -1 -1 -1 -1 48 -1 -1 -1 -1 442 443 444 -1 -1 -1 49 -1 -1 139 140 141 -1 -1 -1 280 281 282 -1 464 465 -1
-1 -1 -1 -1 -1 -1 -1 -1 -1 -1 -1 -1 -1 -1 -1 -1 -1 -1 -1 -1 -1 -1 -1 -1 -1 -1 -1 335 -1 -1 -1 298 299 300 -1 -1 -1 -1
-1 -1 -1 -1 -1 -1 -1 -1 -1 -1 -1 -1 -1 -1 -1 -1 -1 -1 -1 -1 -1 -1 -1 -1 -1 -1 -1 353 354 -1 -1 316 317 318 -1 -1 -1 -1
-1 -1 -1 -1 -1 -1 -1 -1 -1 -1 -1 -1 -1 -1 -1 463 -1 -1 -1 -1 -1 117 118 119 120 -1 -1 371 372 -1 -1 -1 -1 -1 448 449 -1 -1
-1 -1 -1 -1 224 225 226 -1 -1 -1 355 -1 -1 -1 -1 -1 -1 -1 -1 -1 -1 135 136 137 138 -1 -1 -1 -1 -1 -1 -1 -1 -1 466 467 -1 -1
-1 268 269 -1 242 243 244 -1 409 410 373 374 268 269 -1 411 412 -1 -1 -1 -1 153 154 155 156 -1 -1 -1 -1 322 323 -1 -1 -1 -1 -1 -1 -1
-1 286 287 -1 260 261 262 -1 427 428 391 392 286 287 -1 429 430 -1 460 -1 -1 171 172 173 174 175 176 177 -1 340 341 -1 -1 -1 358 359 -1 -1
-1 424 425 426 -1 -1 -1 -1 -1 -1 458 -1 -1 -1 -1 -1 -1 -1 -1 -1 -1 189 190 191 192 193 194 195 -1 -1 -1 -1 -1 -1 376 377 -1 -1
-1 442 443 444 -1 -1 -1 -1 268 269 388 389 390 -1 -1 -1 -1 -1 -1 -1 -1 -1 -1 -1 -1 211 212 213 -1 -1 -1 -1 -1 -1 394 395 -1 -1
-1 -1 -1 -1 -1 82 83 -1 286 287 406 407 408 -1 -1 -1 462 -1 -1 -1 -1 -1 463 -1 -1 229 230 231 -1 -1 -1 -1 -1 -1 -1 -1 -1 -1
-1 82 83 -1 -1 100 101 -1 -1 -1 -1 -1 -1 -1 -1 -1 -1 -1 -1 -1 -1 -1 -1 -1 -1 -1 -1 -1 -1 -1 -1 -1 -1 -1 -1 -1 -1 -1
-1 100 101 -1 -1 -1 -1 -1 -1 -1 458 -1 -1 -1 -1 -1 -1 -1 -1 -1 -1 -1 -1 -1 -1 -1 -1 -1 -1 -1 -1 -1 -1 -1 -1 -1 -1 -1
-1 -1 -1 -1 462 -1 -1 -1 -1 -1 -1 -1 -1 -1 -1 -1 -1 -1 -1 -1 -1 -1 -1 -1 -1 -1 -1 -1 -1 -1 -1 -1 -1 -1 -1 -1 -1 -1
-1 460 82 83 -1 -1 245 246 -1 458 -1 -1 -1 -1 -1 -1 -1 462 -1 -1 -1 -1 -1 -1 -1 -1 -1 -1 -1 -1 -1 -1 -1 -1 -1 -1 -1 -1
-1 -1 100 101 -1 -1 263 264 -1 -1 -1 -1 -1 -1 -1 -1 -1 -1 -1 -1 -1 -1 -1 -1 -1 -1 -1 -1 -1 -1 -1 -1 -1 -1 -1 -1 -1 -1
-1 -1 -1 -1 460 -1 -1 -1 -1 -1 462 -1 -1 -1 -1 -1 -1 -1 -1 -1 -1 -1 -1 -1 -1 -1 -1 -1 -1 -1 -1 -1 -1 -1 -1 -1 -1 -1
