-1 -1 -1 -1 -1 -1 -1 -1 -1 -1 -1 -1 -1 -1 -1 -1 -1 -1 -1 -1 -1 -1 -1 -1 -1 -1 -1 -1 -1 -1 -1 -1 -1 -1 -1 -1 -1 -1
-1 -1 -1 -1 -1 -1 -1 -1 -1 -1 -1 -1 -1 -1 -1 -1 -1 -1 -1 -1 -1 -1 -1 -1 -1 -1 -1 -1 -1 -1 -1 -1 -1 -1 -1 -1 -1 -1
-1 -1 -1 -1 -1 -1 -1 -1 -1 -1 -1 -1 -1 -1 -1 -1 -1 -1 -1 -1 -1 -1 -1 -1 -1 -1 -1 -1 -1 -1 -1 -1 -1 -1 -1 -1 -1 -1
-1 -1 -1 -1 -1 -1 -1 -1 -1 -1 -1 -1 -1 -1 -1 -1 -1 -1 -1 -1 -1 -1 -1 -1 -1 -1 -1 -1 -1 -1 -1 -1 -1 -1 -1 -1 -1 -1
-1 -1 -1 -1 -1 -1 -1 71 -1 -1 71 71 -1 -1 -1 71 -1 -1 71 71 71 71 71 71 71 71 71 71 -1 -1 -1 -1 71 71 -1 -1 -1 -1
-1 -1 -1 -1 -1 -1 -1 71 -1 -1 71 71 -1 -1 -1 71 -1 -1 71 71 71 71 71 71 71 71 71 71 -1 71 71 -1 71 71 -1 -1 -1 -1
-1 -1 -1 -1 -1 -1 71 71 -1 -1 71 71 -1 -1 71 71 -1 -1 71 71 71 71 71 71 71 71 71 71 71 71 71 71 71 71 -1 -1 -1 -1
-1 -1 -1 -1 71 71 71 71 71 71 71 71 71 71 71 71 71 71 71 71 71 71 71 71 71 71 71 71 71 71 71 71 71 71 -1 -1 -1 -1
-1 -1 -1 -1 71 71 71 71 71 71 71 71 71 71 71 71 71 71 71 71 71 71 71 71 71 71 71 71 71 71 71 71 71 71 -1 -1 -1 -1
-1 -1 -1 -1 71 71 71 71 71 71 71 71 71 71 71 71 71 71 71 71 71 71 71 71 71 71 71 71 71 71 71 71 71 71 -1 -1 -1 -1
-1 -1 -1 -1 71 71 71 71 71 71 71 71 71 71 71 71 71 71 71 71 71 71 71 71 71 71 71 71 71 71 71 71 71 71 -1 -1 -1 -1
-1 -1 -1 -1 71 71 71 71 71 71 71 71 71 71 71 71 71 71 71 71 71 71 71 71 71 -1 -1 -1 71 71 71 71 71 -1 -1 -1 -1 -1
-1 -1 -1 -1 -1 -1 71 -1 -1 -1 71 71 -1 -1 71 -1 -1 -1 71 71 71 71 71 71 71 -1 -1 -1 71 71 71 71 71 -1 -1 -1 -1 -1
-1 -1 -1 -1 -1 -1 71 -1 -1 -1 71 71 -1 -1 71 -1 -1 -1 71 71 71 71 71 71 -1 -1 -1 -1 -1 71 71 71 71 -1 -1 -1 -1 -1
-1 -1 -1 -1 -1 -1 71 71 -1 -1 71 71 -1 -1 71 71 -1 -1 71 71 71 71 71 71 -1 -1 -1 -1 -1 71 71 71 71 -1 -1 -1 -1 -1
-1 -1 -1 -1 71 71 71 71 71 71 71 71 71 71 71 71 71 71 71 71 71 71 71 71 -1 -1 -1 -1 -1 71 71 71 71 -1 -1 -1 -1 -1
-1 -1 -1 -1 -1 71 71 71 71 71 71 71 71 71 71 71 71 71 71 71 71 71 71 71 -1 -1 -1 -1 -1 71 71 71 71 -1 -1 -1 -1 -1
-1 -1 -1 -1 -1 71 71 71 71 71 71 71 71 71 71 71 71 71 71 71 71 71 71 71 -1 -1 -1 -1 -1 71 71 71 71 -1 -1 -1 -1 -1
-1 -1 -1 -1 -1 71 71 71 71 71 71 71 71 71 71 71 71 71 71 71 71 71 71 71 -1 -1 -1 -1 -1 71 71 71 71 -1 -1 -1 -1 -1
-1 -1 -1 -1 -1 71 71 71 71 71 71 71 71 71 71 71 71 71 71 71 71 71 71 71 -1 -1 -1 -1 -1 71 71 71 71 -1 -1 -1 -1 -1
-1 -1 -1 -1 71 71 71 71 71 71 71 71 71 71 71 71 71 -1 71 71 71 -1 71 71 71 71 71 71 71 71 71 71 71 -1 -1 -1 -1 -1
-1 -1 -1 -1 71 71 -1 -1 -1 71 71 71 -1 -1 -1 71 71 -1 71 71 71 -1 71 71 71 71 71 71 71 71 71 71 71 71 -1 -1 -1 -1
-1 -1 -1 -1 -1 -1 -1 -1 -1 -1 -1 -1 -1 -1 -1 -1 -1 -1 -1 -1 -1 -1 -1 -1 -1 -1 -1 -1 -1 -1 -1 -1 -1 -1 -1 -1 -1 -1
-1 -1 -1 -1 -1 -1 -1 -1 -1 -1 -1 -1 -1 -1 -1 -1 -1 -1 -1 -1 -1 -1 -1 -1 -1 -1 -1 -1 -1 -1 -1 -1 -1 -1 -1 -1 -1 -1
-1 -1 -1 -1 -1 -1 -1 -1 -1 -1 -1 -1 -1 -1 -1 -1 -1 -1 -1 -1 -1 -1 -1 -1 -1 -1 -1 -1 -1 -1 -1 -1 -1 -1 -1 -1 -1 -1
-1 -1 -1 -1 -1 -1 -1 -1 -1 -1 -1 -1 -1 -1 -1 -1 -1 -1 -1 -1 -1 -1 -1 -1 -1 -1 -1 -1 -1 -1 -1 -1 -1 -1 -1 -1 -1 -1
