-1 -1 -1 -1 -1 -1 -1 -1 -1 -1 -1 -1 -1 -1 -1 -1 -1 -1 -1 -1 -1 -1 -1 -1 -1 -1 -1 -1 -1 -1 -1 -1 -1 -1 -1 -1 -1 -1
-1 -1 -1 -1 -1 -1 -1 -1 -1 -1 -1 -1 -1 -1 -1 -1 -1 -1 -1 -1 -1 -1 -1 -1 -1 -1 -1 -1 -1 -1 -1 -1 -1 -1 -1 -1 -1 -1
-1 -1 -1 -1 -1 -1 -1 -1 -1 -1 -1 -1 -1 -1 -1 -1 -1 -1 -1 -1 -1 -1 -1 -1 -1 -1 -1 -1 -1 -1 -1 -1 -1 -1 -1 -1 -1 -1
-1 -1 -1 -1 -1 -1 -1 -1 -1 -1 -1 -1 -1 -1 -1 -1 -1 -1 -1 -1 -1 -1 -1 -1 -1 -1 -1 -1 -1 -1 -1 -1 -1 -1 -1 -1 -1 -1
-1 -1 -1 -1 136 137 16 -1 136 137 -1 -1 136 137 16 -1 136 137 -1 -1 -1 -1 -1 -1 -1 -1 -1 -1 11 1 2 13 -1 -1 -1 -1 -1 -1
-1 -1 -1 -1 132 133 32 -1 138 139 -1 -1 132 133 32 -1 138 139 -1 -1 -1 -1 -1 -1 -1 -1 -1 -1 27 -1 -1 29 -1 -1 -1 -1 -1 -1
-1 -1 -1 -1 134 135 -1 -1 140 141 -1 -1 134 135 -1 -1 140 141 -1 -1 -1 -1 -1 -1 -1 -1 -1 -1 43 -1 -1 45 -1 -1 -1 -1 -1 -1
-1 -1 -1 -1 -1 -1 -1 -1 -1 -1 -1 -1 -1 -1 -1 -1 -1 -1 -1 -1 -1 -1 -1 -1 -1 -1 48 49 49 49 49 49 49 50 -1 -1 -1 -1
-1 -1 -1 -1 48 49 49 49 49 49 49 49 49 49 49 49 49 49 49 49 50 -1 -1 -1 -1 -1 64 65 65 65 65 65 65 66 -1 -1 -1 -1
-1 -1 -1 -1 64 65 65 65 65 65 65 65 65 65 65 65 65 65 65 65 66 -1 -1 -1 -1 -1 80 81 81 81 81 81 81 82 -1 -1 -1 -1
-1 -1 -1 -1 80 81 81 81 81 81 81 81 81 81 81 81 81 81 65 65 66 -1 -1 -1 -1 -1 -1 -1 -1 -1 -1 -1 -1 -1 -1 -1 -1 -1
-1 -1 -1 -1 -1 -1 -1 -1 -1 -1 -1 -1 -1 -1 -1 -1 -1 -1 64 65 66 -1 -1 -1 -1 10 10 10 -1 -1 -1 -1 -1 15 -1 -1 -1 -1
-1 -1 -1 -1 136 137 -1 16 136 137 -1 -1 136 137 -1 16 136 137 64 65 66 -1 -1 -1 -1 26 26 26 -1 -1 -1 -1 -1 31 -1 -1 -1 -1
-1 -1 -1 -1 138 139 -1 32 132 133 -1 -1 138 139 -1 32 132 133 64 65 66 -1 -1 -1 9 99 100 59 8 -1 -1 -1 -1 47 -1 -1 -1 -1
-1 -1 -1 -1 140 141 -1 -1 134 135 -1 -1 140 141 -1 -1 134 135 64 65 66 -1 -1 -1 9 73 116 117 8 -1 -1 -1 -1 63 -1 -1 -1 -1
-1 -1 -1 -1 -1 -1 -1 -1 -1 -1 -1 -1 -1 -1 -1 -1 -1 -1 64 65 66 -1 -1 -1 9 73 74 75 8 -1 -1 -1 -1 16 -1 -1 -1 -1
-1 -1 -1 -1 14 -1 -1 -1 -1 -1 -1 -1 -1 -1 -1 -1 -1 -1 64 65 66 -1 -1 -1 9 73 74 75 8 -1 -1 -1 -1 32 -1 -1 -1 -1
-1 -1 -1 -1 30 -1 -1 -1 -1 -1 -1 -1 -1 -1 -1 -1 -1 -1 64 65 66 -1 -1 -1 9 115 116 117 8 -1 -1 -1 -1 15 -1 -1 -1 -1
-1 -1 -1 -1 46 -1 -1 -1 -1 -1 -1 -1 -1 -1 -1 -1 -1 -1 64 65 66 -1 -1 -1 9 73 74 75 8 -1 -1 -1 -1 31 -1 -1 -1 -1
-1 -1 -1 -1 62 -1 -1 -1 -1 -1 -1 -1 -1 -1 -1 -1 -1 -1 64 65 66 -1 -1 -1 25 89 90 91 8 -1 -1 -1 -1 47 -1 -1 -1 -1
-1 -1 -1 -1 -1 -1 -1 -1 -1 -1 -1 -1 -1 -1 -1 -1 -1 16 64 65 66 16 -1 -1 41 -1 -1 -1 41 -1 -1 -1 -1 63 -1 -1 -1 -1
-1 -1 -1 -1 -1 -1 92 93 94 -1 -1 -1 92 93 94 -1 -1 32 64 65 66 32 -1 -1 -1 -1 -1 -1 -1 -1 -1 -1 -1 -1 -1 -1 -1 -1
-1 -1 -1 -1 -1 -1 -1 -1 -1 -1 -1 -1 -1 -1 -1 -1 -1 -1 -1 -1 -1 -1 -1 -1 -1 -1 -1 -1 -1 -1 -1 -1 -1 -1 -1 -1 -1 -1
-1 -1 -1 -1 -1 -1 -1 -1 -1 -1 -1 -1 -1 -1 -1 -1 -1 -1 -1 -1 -1 -1 -1 -1 -1 -1 -1 -1 -1 -1 -1 -1 -1 -1 -1 -1 -1 -1
-1 -1 -1 -1 -1 -1 -1 -1 -1 -1 -1 -1 -1 -1 -1 -1 -1 -1 -1 -1 -1 -1 -1 -1 -1 -1 -1 -1 -1 -1 -1 -1 -1 -1 -1 -1 -1 -1
-1 -1 -1 -1 -1 -1 -1 -1 -1 -1 -1 -1 -1 -1 -1 -1 -1 -1 -1 -1 -1 -1 -1 -1 -1 -1 -1 -1 -1 -1 -1 -1 -1 -1 -1 -1 -1 -1
